{
  "name": "Castle Wolfenstein - Floor 1",
  "episode": 1,
  "floor": 1,
  "width": 32,
  "height": 32,
  "wallHeight": 2.0,
  "playerStart": { "x": 2, "z": 2, "angle": 90 },
  "walls": [
    [1,1,1,1,1,1,1,1,1,1,1,1,1,1,1,1,1,1,1,1,1,1,1,1,1,1,1,1,1,1,1,1],
    [1,4,4,1,1,1,1,1,1,1,3,3,3,3,3,3,3,5,5,5,5,5,5,5,1,1,1,1,1,1,1,1],
    [1,0,0,0,0,0,0,0,0,8,0,0,0,0,0,0,3,5,0,0,0,0,0,5,1,1,1,1,1,1,1,1],
    [1,0,0,1,1,1,1,1,1,1,3,0,0,0,0,0,8,0,0,0,0,0,0,6,1,1,1,1,1,1,1,1],
    [1,4,4,1,1,1,1,1,1,1,3,0,0,0,0,0,3,5,0,0,0,6,0,5,1,1,1,1,1,1,1,1],
    [1,1,1,1,1,1,1,1,1,1,3,3,3,0,3,3,3,5,5,5,5,5,5,5,1,1,1,1,1,1,1,1],
    [1,1,1,1,1,1,1,1,1,1,1,1,3,0,3,1,1,1,1,1,1,1,1,1,1,1,1,1,1,1,1,1],
    [1,1,1,1,1,1,1,1,1,1,1,1,3,0,0,3,3,3,3,3,3,3,3,3,2,3,3,3,1,1,1,1],
    [1,1,1,1,1,1,1,1,1,1,1,1,3,0,0,0,0,0,0,0,8,0,0,0,0,0,0,3,1,1,1,1],
    [1,1,1,1,1,1,1,1,1,1,1,1,3,3,3,3,3,3,3,3,3,3,0,0,0,0,0,3,1,1,1,1],
    [1,1,1,1,1,1,1,1,1,1,1,1,1,1,1,1,1,1,1,1,1,3,0,3,0,3,0,3,1,1,1,1],
    [1,1,1,1,1,1,1,1,1,1,1,1,1,1,1,1,1,1,1,1,1,3,0,0,0,0,0,3,1,1,1,1],
    [1,1,1,1,1,1,1,1,1,1,1,1,1,1,1,1,1,1,1,0,0,3,0,0,0,0,0,3,1,1,1,1],
    [1,1,1,1,1,1,1,1,1,1,1,1,1,1,1,1,1,1,1,1,1,3,0,3,0,3,0,3,1,1,1,1],
    [1,1,1,1,1,1,1,1,1,1,1,1,1,1,1,1,1,1,1,1,1,3,0,0,0,0,0,3,1,1,1,1],
    [1,1,1,1,1,1,1,1,1,1,1,1,1,1,1,1,1,1,1,1,1,3,0,0,0,0,0,3,1,1,1,1],
    [1,1,1,1,1,1,1,1,1,1,1,1,1,1,1,1,1,1,1,1,1,3,3,3,3,3,8,3,1,1,1,1],
    [1,1,1,1,1,1,1,1,1,1,1,1,1,1,1,1,1,1,1,1,1,1,1,1,1,7,0,7,1,1,1,1],
    [1,1,1,1,1,1,1,1,1,1,1,1,1,1,1,1,1,1,1,1,1,1,1,1,1,7,0,7,1,1,1,1],
    [1,1,1,1,1,1,1,1,1,1,1,1,1,1,1,1,1,1,1,1,1,1,1,1,1,9,0,9,1,1,1,1],
    [1,1,1,1,1,1,1,1,1,1,1,1,1,1,1,1,1,1,1,1,1,1,1,1,1,1,1,1,1,1,1,1],
    [1,1,1,1,1,1,1,1,1,1,1,1,1,1,1,1,1,1,1,1,1,1,1,1,1,1,1,1,1,1,1,1],
    [1,1,1,1,1,1,1,1,1,1,1,1,1,1,1,1,1,1,1,1,1,1,1,1,1,1,1,1,1,1,1,1],
    [1,1,1,1,1,1,1,1,1,1,1,1,1,1,1,1,1,1,1,1,1,1,1,1,1,1,1,1,1,1,1,1],
    [1,1,1,1,1,1,1,1,1,1,1,1,1,1,1,1,1,1,1,1,1,1,1,1,1,1,1,1,1,1,1,1],
    [1,1,1,1,1,1,1,1,1,1,1,1,1,1,1,1,1,1,1,1,1,1,1,1,1,1,1,1,1,1,1,1],
    [1,1,1,1,1,1,1,1,1,1,1,1,1,1,1,1,1,1,1,1,1,1,1,1,1,1,1,1,1,1,1,1],
    [1,1,1,1,1,1,1,1,1,1,1,1,1,1,1,1,1,1,1,1,1,1,1,1,1,1,1,1,1,1,1,1],
    [1,1,1,1,1,1,1,1,1,1,1,1,1,1,1,1,1,1,1,1,1,1,1,1,1,1,1,1,1,1,1,1],
    [1,1,1,1,1,1,1,1,1,1,1,1,1,1,1,1,1,1,1,1,1,1,1,1,1,1,1,1,1,1,1,1],
    [1,1,1,1,1,1,1,1,1,1,1,1,1,1,1,1,1,1,1,1,1,1,1,1,1,1,1,1,1,1,1,1],
    [1,1,1,1,1,1,1,1,1,1,1,1,1,1,1,1,1,1,1,1,1,1,1,1,1,1,1,1,1,1,1,1]
  ],
  "doors": [
    { "x": 9, "z": 2, "axis": "z", "type": "normal" },
    { "x": 16, "z": 3, "axis": "z", "type": "normal" },
    { "x": 20, "z": 8, "axis": "z", "type": "gold" },
    { "x": 26, "z": 16, "axis": "x", "type": "normal" }
  ],
  "entities": [
    { "type": "guard", "x": 5.5, "z": 2.5, "angle": 270, "patrol": false },
    { "type": "guard", "x": 13.5, "z": 2.5, "angle": 180, "patrol": false },
    { "type": "guard", "x": 15.5, "z": 3.5, "angle": 90, "patrol": false },
    { "type": "guard", "x": 12.5, "z": 4.5, "angle": 0, "patrol": true },
    { "type": "guard", "x": 13.5, "z": 7.5, "angle": 0, "patrol": true },
    { "type": "guard", "x": 22.5, "z": 9.5, "angle": 180, "patrol": false },
    { "type": "guard", "x": 26.5, "z": 11.5, "angle": 270, "patrol": false },
    { "type": "guard", "x": 24.5, "z": 14.5, "angle": 0, "patrol": false },
    { "type": "guard", "x": 22.5, "z": 8.5, "angle": 90, "patrol": true },
    { "type": "guard", "x": 26.5, "z": 18.5, "angle": 180, "patrol": false }
  ],
  "items": [
    { "type": "pistol_ammo", "x": 1.5, "z": 3.5 },
    { "type": "health_small", "x": 7.5, "z": 2.5 },
    { "type": "pistol_ammo", "x": 12.5, "z": 4.5 },
    { "type": "health_small", "x": 15.5, "z": 2.5 },
    { "type": "gold_key", "x": 21.5, "z": 3.5 },
    { "type": "pistol_ammo", "x": 20.5, "z": 4.5 },
    { "type": "treasure_cross", "x": 22.5, "z": 2.5 },
    { "type": "pistol_ammo", "x": 17.5, "z": 8.5 },
    { "type": "health_large", "x": 24.5, "z": 12.5 },
    { "type": "treasure_goblet", "x": 22.5, "z": 15.5 },
    { "type": "treasure_chest", "x": 26.5, "z": 9.5 },
    { "type": "pistol_ammo", "x": 26.5, "z": 14.5 },
    { "type": "health_small", "x": 26.5, "z": 18.5 }
  ],
  "secrets": [
    { "x": 21, "z": 12, "pushDir": "west" }
  ],
  "secretItems": [
    { "type": "treasure_crown", "x": 20.5, "z": 12.5 },
    { "type": "health_large", "x": 19.5, "z": 12.5 }
  ],
  "exit": { "x": 26, "z": 19 },
  "par_time": 90,
  "music": "e1m1"
}
