{
  "name": "Schabbs' Lair",
  "episode": 2,
  "floor": 10,
  "width": 32,
  "height": 32,
  "wallHeight": 2.0,
  "isBossLevel": true,
  "bossType": "boss_schabbs",
  "playerStart": { "x": 15, "z": 2, "angle": 0 },
  "walls": [
    [1,1,1,1,1,1,1,1,1,1,1,1,1,1,1,1,1,1,1,1,1,1,1,1,1,1,1,1,1,1,1,1],
    [1,1,1,1,1,1,1,1,1,1,1,1,1,1,1,1,1,1,1,1,1,1,1,1,1,1,1,1,1,1,1,1],
    [1,1,1,1,1,1,1,1,1,1,1,1,1,1,0,0,0,1,1,1,1,1,1,1,1,1,1,1,1,1,1,1],
    [1,1,1,1,1,1,1,1,1,1,1,1,1,1,0,0,0,1,1,1,1,1,1,1,1,1,1,1,1,1,1,1],
    [1,1,1,1,1,1,1,1,1,1,1,1,1,1,0,0,0,1,1,1,1,1,1,1,1,1,1,1,1,1,1,1],
    [1,1,1,1,1,1,1,1,1,1,1,1,1,1,0,0,0,1,1,1,1,1,1,1,1,1,1,1,1,1,1,1],
    [1,1,1,1,1,1,1,1,1,1,1,1,1,1,1,8,1,1,1,1,1,1,1,1,1,1,1,1,1,1,1,1],
    [1,1,1,1,1,1,1,1,1,1,1,1,3,0,0,0,0,0,3,1,1,1,1,1,1,1,1,1,1,1,1,1],
    [1,1,1,1,1,1,1,1,1,1,1,1,3,0,0,0,0,0,3,1,1,1,1,1,1,1,1,1,1,1,1,1],
    [1,1,1,1,1,1,1,1,1,1,1,1,3,0,0,0,0,0,3,1,1,1,1,1,1,1,1,1,1,1,1,1],
    [1,1,1,1,1,1,1,1,1,1,1,1,3,3,3,8,3,3,3,1,1,1,1,1,1,1,1,1,1,1,1,1],
    [1,1,1,1,1,1,1,1,7,7,7,7,7,0,0,0,0,0,7,7,7,7,7,1,1,1,1,1,1,1,1,1],
    [1,1,1,1,1,1,1,1,7,0,0,0,0,0,0,0,0,0,0,0,0,0,7,1,1,1,1,1,1,1,1,1],
    [1,1,1,1,1,1,1,1,7,0,0,0,0,0,0,0,0,0,0,0,0,0,7,1,1,1,1,1,1,1,1,1],
    [1,1,1,1,1,1,1,1,7,0,0,0,0,0,0,0,0,0,0,0,0,0,7,1,1,1,1,1,1,1,1,1],
    [1,1,1,1,1,1,1,1,7,0,0,0,0,0,0,0,0,0,0,0,0,0,7,1,1,1,1,1,1,1,1,1],
    [1,1,1,1,1,1,1,1,7,0,0,0,0,0,0,0,0,0,0,0,0,0,7,1,1,1,1,1,1,1,1,1],
    [1,1,1,1,1,1,1,1,7,0,0,0,0,0,0,0,0,0,0,0,0,0,7,1,1,1,1,1,1,1,1,1],
    [1,1,1,1,1,1,1,1,7,0,0,0,0,0,0,0,0,0,0,0,0,0,7,1,1,1,1,1,1,1,1,1],
    [1,1,1,1,1,1,1,1,7,0,0,0,0,0,0,0,0,0,0,0,0,0,7,1,1,1,1,1,1,1,1,1],
    [1,1,1,1,1,1,1,1,7,7,7,7,7,7,7,9,7,7,7,7,7,7,7,1,1,1,1,1,1,1,1,1],
    [1,1,1,1,1,1,1,1,1,1,1,1,1,1,1,0,1,1,1,1,1,1,1,1,1,1,1,1,1,1,1,1],
    [1,1,1,1,1,1,1,1,1,1,1,1,1,1,1,1,1,1,1,1,1,1,1,1,1,1,1,1,1,1,1,1],
    [1,1,1,1,1,1,1,1,1,1,1,1,1,1,1,1,1,1,1,1,1,1,1,1,1,1,1,1,1,1,1,1],
    [1,1,1,1,1,1,1,1,1,1,1,1,1,1,1,1,1,1,1,1,1,1,1,1,1,1,1,1,1,1,1,1],
    [1,1,1,1,1,1,1,1,1,1,1,1,1,1,1,1,1,1,1,1,1,1,1,1,1,1,1,1,1,1,1,1],
    [1,1,1,1,1,1,1,1,1,1,1,1,1,1,1,1,1,1,1,1,1,1,1,1,1,1,1,1,1,1,1,1],
    [1,1,1,1,1,1,1,1,1,1,1,1,1,1,1,1,1,1,1,1,1,1,1,1,1,1,1,1,1,1,1,1],
    [1,1,1,1,1,1,1,1,1,1,1,1,1,1,1,1,1,1,1,1,1,1,1,1,1,1,1,1,1,1,1,1],
    [1,1,1,1,1,1,1,1,1,1,1,1,1,1,1,1,1,1,1,1,1,1,1,1,1,1,1,1,1,1,1,1],
    [1,1,1,1,1,1,1,1,1,1,1,1,1,1,1,1,1,1,1,1,1,1,1,1,1,1,1,1,1,1,1,1],
    [1,1,1,1,1,1,1,1,1,1,1,1,1,1,1,1,1,1,1,1,1,1,1,1,1,1,1,1,1,1,1,1]
  ],
  "doors": [
    { "x": 15, "z": 6, "axis": "x", "type": "normal" },
    { "x": 15, "z": 10, "axis": "x", "type": "normal", "bossDoor": true }
  ],
  "entities": [],
  "items": [
    { "type": "health_large", "x": 14.5, "z": 7.5 },
    { "type": "health_large", "x": 16.5, "z": 7.5 },
    { "type": "mp40_ammo", "x": 13.5, "z": 8.5 },
    { "type": "mp40_ammo", "x": 17.5, "z": 8.5 },
    { "type": "pistol_ammo", "x": 14.5, "z": 8.5 },
    { "type": "pistol_ammo", "x": 16.5, "z": 8.5 },
    { "type": "health_small", "x": 13.5, "z": 9.5 },
    { "type": "health_small", "x": 17.5, "z": 9.5 },
    { "type": "health_large", "x": 15.5, "z": 9.5 },
    { "type": "mp40_ammo", "x": 15.5, "z": 7.5 }
  ],
  "boss": {
    "type": "boss_schabbs",
    "x": 15.5,
    "z": 18.5,
    "triggerZone": {
      "minX": 9,
      "maxX": 22,
      "minZ": 11,
      "maxZ": 20
    }
  },
  "secrets": [],
  "secretItems": [],
  "exit": { "x": 15, "z": 19 },
  "exitLocked": true,
  "par_time": 120,
  "music": "e2m1"
}
