{
  "name": "The Throne Room",
  "episode": 3,
  "floor": 10,
  "width": 32,
  "height": 32,
  "wallHeight": 2.0,
  "isBossLevel": true,
  "bossType": "boss_hitler",
  "playerStart": { "x": 15, "z": 2, "angle": 0 },
  "walls": [
    [1,1,1,1,1,1,1,1,1,1,1,1,1,1,1,1,1,1,1,1,1,1,1,1,1,1,1,1,1,1,1,1],
    [1,1,1,1,1,1,1,1,1,1,1,1,1,1,1,1,1,1,1,1,1,1,1,1,1,1,1,1,1,1,1,1],
    [1,1,1,1,1,1,1,1,1,1,1,1,1,7,0,0,0,7,1,1,1,1,1,1,1,1,1,1,1,1,1,1],
    [1,1,1,1,1,1,1,1,1,1,1,1,1,7,0,0,0,7,1,1,1,1,1,1,1,1,1,1,1,1,1,1],
    [1,1,1,1,1,1,1,1,1,1,1,1,1,7,0,0,0,7,1,1,1,1,1,1,1,1,1,1,1,1,1,1],
    [1,1,1,1,1,1,1,1,1,1,1,1,1,7,0,0,0,7,1,1,1,1,1,1,1,1,1,1,1,1,1,1],
    [1,1,1,1,1,1,1,1,1,1,1,1,1,7,7,8,7,7,1,1,1,1,1,1,1,1,1,1,1,1,1,1],
    [1,1,1,1,1,1,1,1,1,7,7,7,7,7,0,0,0,7,7,7,7,7,1,1,1,1,1,1,1,1,1,1],
    [1,1,1,1,1,1,1,1,1,7,0,0,0,0,0,0,0,0,0,0,0,7,1,1,1,1,1,1,1,1,1,1],
    [1,1,1,1,1,1,1,1,1,7,0,0,0,0,0,0,0,0,0,0,0,7,1,1,1,1,1,1,1,1,1,1],
    [1,1,1,1,1,1,1,1,1,7,0,0,0,0,0,0,0,0,0,0,0,7,1,1,1,1,1,1,1,1,1,1],
    [1,1,1,1,1,1,1,1,1,7,7,7,7,7,7,8,7,7,7,7,7,7,1,1,1,1,1,1,1,1,1,1],
    [1,1,1,1,1,1,7,7,7,7,0,0,0,0,0,0,0,0,0,0,0,7,7,7,7,1,1,1,1,1,1,1],
    [1,1,1,1,1,1,7,0,0,0,0,0,0,0,0,0,0,0,0,0,0,0,0,0,7,1,1,1,1,1,1,1],
    [1,1,1,1,1,1,7,0,0,0,0,0,0,0,0,0,0,0,0,0,0,0,0,0,7,1,1,1,1,1,1,1],
    [1,1,1,1,1,1,7,0,0,0,0,7,0,0,0,0,0,0,0,7,0,0,0,0,7,1,1,1,1,1,1,1],
    [1,1,1,1,1,1,7,0,0,0,0,0,0,0,0,0,0,0,0,0,0,0,0,0,7,1,1,1,1,1,1,1],
    [1,1,1,1,1,1,7,0,0,0,0,0,0,0,0,0,0,0,0,0,0,0,0,0,7,1,1,1,1,1,1,1],
    [1,1,1,1,1,1,7,0,0,0,0,7,0,0,0,0,0,0,0,7,0,0,0,0,7,1,1,1,1,1,1,1],
    [1,1,1,1,1,1,7,0,0,0,0,0,0,0,0,0,0,0,0,0,0,0,0,0,7,1,1,1,1,1,1,1],
    [1,1,1,1,1,1,7,0,0,0,0,0,0,0,0,0,0,0,0,0,0,0,0,0,7,1,1,1,1,1,1,1],
    [1,1,1,1,1,1,7,0,0,0,0,7,0,0,0,0,0,0,0,7,0,0,0,0,7,1,1,1,1,1,1,1],
    [1,1,1,1,1,1,7,0,0,0,0,0,0,0,0,0,0,0,0,0,0,0,0,0,7,1,1,1,1,1,1,1],
    [1,1,1,1,1,1,7,7,7,7,7,7,7,7,7,9,7,7,7,7,7,7,7,7,7,1,1,1,1,1,1,1],
    [1,1,1,1,1,1,1,1,1,1,1,1,1,1,1,0,1,1,1,1,1,1,1,1,1,1,1,1,1,1,1,1],
    [1,1,1,1,1,1,1,1,1,1,1,1,1,1,1,1,1,1,1,1,1,1,1,1,1,1,1,1,1,1,1,1],
    [1,1,1,1,1,1,1,1,1,1,1,1,1,1,1,1,1,1,1,1,1,1,1,1,1,1,1,1,1,1,1,1],
    [1,1,1,1,1,1,1,1,1,1,1,1,1,1,1,1,1,1,1,1,1,1,1,1,1,1,1,1,1,1,1,1],
    [1,1,1,1,1,1,1,1,1,1,1,1,1,1,1,1,1,1,1,1,1,1,1,1,1,1,1,1,1,1,1,1],
    [1,1,1,1,1,1,1,1,1,1,1,1,1,1,1,1,1,1,1,1,1,1,1,1,1,1,1,1,1,1,1,1],
    [1,1,1,1,1,1,1,1,1,1,1,1,1,1,1,1,1,1,1,1,1,1,1,1,1,1,1,1,1,1,1,1],
    [1,1,1,1,1,1,1,1,1,1,1,1,1,1,1,1,1,1,1,1,1,1,1,1,1,1,1,1,1,1,1,1]
  ],
  "doors": [
    { "x": 15, "z": 6, "axis": "x", "type": "normal" },
    { "x": 15, "z": 11, "axis": "x", "type": "normal", "bossDoor": true }
  ],
  "entities": [],
  "items": [
    { "type": "health_large", "x": 14.5, "z": 7.5 },
    { "type": "health_large", "x": 16.5, "z": 7.5 },
    { "type": "health_large", "x": 15.5, "z": 7.5 },
    { "type": "mp40_ammo", "x": 14.5, "z": 8.5 },
    { "type": "mp40_ammo", "x": 16.5, "z": 8.5 },
    { "type": "pistol_ammo", "x": 15.5, "z": 8.5 },
    { "type": "mp40_ammo", "x": 10.5, "z": 9.5 },
    { "type": "mp40_ammo", "x": 20.5, "z": 9.5 },
    { "type": "health_large", "x": 10.5, "z": 10.5 },
    { "type": "health_large", "x": 20.5, "z": 10.5 },
    { "type": "pistol_ammo", "x": 14.5, "z": 9.5 },
    { "type": "pistol_ammo", "x": 16.5, "z": 9.5 },
    { "type": "health_small", "x": 10.5, "z": 8.5 },
    { "type": "health_small", "x": 20.5, "z": 8.5 }
  ],
  "boss": {
    "type": "boss_hitler",
    "x": 15.5,
    "z": 20.5,
    "phases": 2,
    "triggerZone": {
      "minX": 7,
      "maxX": 24,
      "minZ": 12,
      "maxZ": 23
    }
  },
  "secrets": [],
  "secretItems": [],
  "exit": { "x": 15, "z": 23 },
  "exitLocked": true,
  "par_time": 150,
  "music": "e3m1"
}