{
  "name": "Gretel's Arena",
  "episode": 5,
  "floor": 10,
  "width": 32,
  "height": 32,
  "wallHeight": 2.0,
  "isBossLevel": true,
  "bossType": "gretel",
  "playerStart": { "x": 16, "z": 2, "angle": 0 },
  "walls": [
    [1,1,1,1,1,1,1,1,1,1,1,1,1,1,1,1,1,1,1,1,1,1,1,1,1,1,1,1,1,1,1,1],
    [1,1,1,1,1,1,1,1,1,1,1,1,1,1,1,7,7,1,1,1,1,1,1,1,1,1,1,1,1,1,1,1],
    [1,1,1,1,1,1,1,1,1,1,1,1,1,1,1,0,0,1,1,1,1,1,1,1,1,1,1,1,1,1,1,1],
    [1,1,1,1,1,1,1,1,1,1,1,1,1,1,1,0,0,1,1,1,1,1,1,1,1,1,1,1,1,1,1,1],
    [1,1,1,1,1,1,1,1,1,1,1,1,1,1,1,0,0,1,1,1,1,1,1,1,1,1,1,1,1,1,1,1],
    [1,1,1,1,1,1,1,1,1,1,1,1,1,1,1,0,0,1,1,1,1,1,1,1,1,1,1,1,1,1,1,1],
    [1,1,1,1,1,1,1,1,1,1,1,1,1,1,1,8,8,1,1,1,1,1,1,1,1,1,1,1,1,1,1,1],
    [1,1,1,1,1,1,1,1,1,1,1,1,7,7,7,0,0,7,7,7,1,1,1,1,1,1,1,1,1,1,1,1],
    [1,1,1,1,1,1,1,1,1,1,1,1,7,0,0,0,0,0,0,7,1,1,1,1,1,1,1,1,1,1,1,1],
    [1,1,1,1,1,1,1,1,1,1,1,1,7,0,0,0,0,0,0,7,1,1,1,1,1,1,1,1,1,1,1,1],
    [1,1,1,1,1,1,1,1,1,1,1,1,7,0,0,0,0,0,0,7,1,1,1,1,1,1,1,1,1,1,1,1],
    [1,1,1,1,1,1,1,1,1,1,1,1,7,7,7,8,8,7,7,7,1,1,1,1,1,1,1,1,1,1,1,1],
    [1,1,1,1,1,1,1,1,1,1,7,7,7,7,7,0,0,7,7,7,7,7,1,1,1,1,1,1,1,1,1,1],
    [1,1,1,1,1,1,1,1,1,1,7,0,0,0,0,0,0,0,0,0,0,7,1,1,1,1,1,1,1,1,1,1],
    [1,1,1,1,1,1,1,1,1,1,7,0,0,0,0,0,0,0,0,0,0,7,1,1,1,1,1,1,1,1,1,1],
    [1,1,1,1,1,1,1,1,1,1,7,0,0,0,7,0,0,7,0,0,0,7,1,1,1,1,1,1,1,1,1,1],
    [1,1,1,1,1,1,1,1,1,1,7,0,0,0,0,0,0,0,0,0,0,7,1,1,1,1,1,1,1,1,1,1],
    [1,1,1,1,1,1,1,1,1,1,7,0,0,0,0,0,0,0,0,0,0,7,1,1,1,1,1,1,1,1,1,1],
    [1,1,1,1,1,1,1,1,1,1,7,0,0,0,7,0,0,7,0,0,0,7,1,1,1,1,1,1,1,1,1,1],
    [1,1,1,1,1,1,1,1,1,1,7,0,0,0,0,0,0,0,0,0,0,7,1,1,1,1,1,1,1,1,1,1],
    [1,1,1,1,1,1,1,1,1,1,7,0,0,0,0,0,0,0,0,0,0,7,1,1,1,1,1,1,1,1,1,1],
    [1,1,1,1,1,1,1,1,1,1,7,0,0,0,0,0,0,0,0,0,0,7,1,1,1,1,1,1,1,1,1,1],
    [1,1,1,1,1,1,1,1,1,1,7,7,7,7,7,7,9,7,7,7,7,7,1,1,1,1,1,1,1,1,1,1],
    [1,1,1,1,1,1,1,1,1,1,1,1,1,1,1,1,0,1,1,1,1,1,1,1,1,1,1,1,1,1,1,1],
    [1,1,1,1,1,1,1,1,1,1,1,1,1,1,1,1,1,1,1,1,1,1,1,1,1,1,1,1,1,1,1,1],
    [1,1,1,1,1,1,1,1,1,1,1,1,1,1,1,1,1,1,1,1,1,1,1,1,1,1,1,1,1,1,1,1],
    [1,1,1,1,1,1,1,1,1,1,1,1,1,1,1,1,1,1,1,1,1,1,1,1,1,1,1,1,1,1,1,1],
    [1,1,1,1,1,1,1,1,1,1,1,1,1,1,1,1,1,1,1,1,1,1,1,1,1,1,1,1,1,1,1,1],
    [1,1,1,1,1,1,1,1,1,1,1,1,1,1,1,1,1,1,1,1,1,1,1,1,1,1,1,1,1,1,1,1],
    [1,1,1,1,1,1,1,1,1,1,1,1,1,1,1,1,1,1,1,1,1,1,1,1,1,1,1,1,1,1,1,1],
    [1,1,1,1,1,1,1,1,1,1,1,1,1,1,1,1,1,1,1,1,1,1,1,1,1,1,1,1,1,1,1,1],
    [1,1,1,1,1,1,1,1,1,1,1,1,1,1,1,1,1,1,1,1,1,1,1,1,1,1,1,1,1,1,1,1]
  ],
  "doors": [
    { "x": 15, "z": 6, "axis": "x", "type": "normal" },
    { "x": 16, "z": 6, "axis": "x", "type": "normal" },
    { "x": 15, "z": 11, "axis": "x", "type": "normal", "bossDoor": true },
    { "x": 16, "z": 11, "axis": "x", "type": "normal", "bossDoor": true }
  ],
  "entities": [],
  "items": [
    { "type": "health_large", "x": 13.5, "z": 8.5 },
    { "type": "health_large", "x": 18.5, "z": 8.5 },
    { "type": "pistol_ammo", "x": 13.5, "z": 9.5 },
    { "type": "pistol_ammo", "x": 18.5, "z": 9.5 },
    { "type": "pistol_ammo", "x": 15.5, "z": 8.5 },
    { "type": "pistol_ammo", "x": 16.5, "z": 8.5 },
    { "type": "health_small", "x": 13.5, "z": 10.5 },
    { "type": "health_small", "x": 18.5, "z": 10.5 },
    { "type": "health_large", "x": 15.5, "z": 10.5 },
    { "type": "health_large", "x": 16.5, "z": 10.5 }
  ],
  "boss": {
    "type": "gretel",
    "x": 15.5,
    "z": 20.5,
    "triggerZone": {
      "minX": 10,
      "maxX": 22,
      "minZ": 12,
      "maxZ": 22
    }
  },
  "secrets": [],
  "secretItems": [],
  "exit": { "x": 16, "z": 22 },
  "exitLocked": true,
  "par_time": 120,
  "music": "e5_boss"
}