{
  "name": "Forest Approach",
  "episode": 5,
  "floor": 1,
  "width": 32,
  "height": 32,
  "wallHeight": 2.0,
  "playerStart": { "x": 2, "z": 30, "angle": 0 },
  "walls": [
    [1,1,1,1,1,1,1,1,1,1,1,1,1,1,1,1,1,1,1,1,1,1,1,1,1,1,1,1,1,1,1,1],
    [1,0,0,0,0,0,0,0,0,0,0,0,0,1,0,0,0,0,0,0,0,0,1,0,0,0,0,0,0,0,0,1],
    [1,0,0,0,0,0,0,0,0,0,0,0,0,0,0,0,0,0,1,0,0,0,0,0,0,0,0,0,0,0,0,1],
    [1,0,0,1,0,0,0,0,1,0,0,0,0,0,0,0,0,0,0,0,0,1,0,0,0,1,1,0,0,0,0,1],
    [1,0,0,0,0,0,0,0,0,0,0,0,0,0,0,1,0,0,0,0,0,0,0,0,0,0,1,0,0,0,0,1],
    [1,0,0,0,0,0,0,0,0,0,0,1,0,0,0,0,0,0,0,0,0,0,0,0,0,0,0,0,0,1,0,1],
    [1,0,0,0,0,0,0,0,0,0,0,0,0,0,0,0,0,1,0,0,0,0,0,0,1,0,0,0,0,0,0,1],
    [1,0,0,1,0,0,0,0,0,0,0,0,0,0,0,0,0,0,0,0,0,0,0,0,0,0,0,0,0,0,0,1],
    [1,0,0,0,0,0,0,0,1,1,0,0,0,0,0,0,0,0,0,0,1,0,0,0,0,0,0,0,0,0,0,1],
    [1,0,0,0,0,0,0,0,1,1,0,0,0,0,0,0,0,0,0,0,0,0,0,0,0,0,0,1,0,0,0,1],
    [1,0,0,0,0,0,0,0,0,0,0,0,0,0,1,0,0,0,0,0,0,0,0,0,0,0,0,0,0,0,0,1],
    [1,0,0,0,0,0,0,0,0,0,0,0,0,0,0,0,0,0,0,0,0,0,0,0,0,0,0,0,0,0,0,1],
    [1,1,1,1,1,1,0,0,0,0,0,0,0,0,0,0,0,0,0,0,0,1,0,0,0,0,0,0,1,0,0,1],
    [1,0,0,0,0,1,0,0,0,0,0,1,0,0,0,0,0,0,0,0,0,0,0,0,0,0,0,0,0,0,0,1],
    [1,0,0,0,0,1,0,0,0,0,0,0,0,0,0,0,1,0,0,0,0,0,0,0,0,0,0,0,0,0,0,1],
    [1,0,0,0,0,0,0,0,0,0,0,0,0,0,0,0,0,0,0,0,0,0,0,1,0,0,0,0,0,0,0,1],
    [1,0,0,0,0,0,0,0,0,1,0,0,0,0,0,0,0,0,0,0,0,0,0,0,0,0,0,0,0,0,0,1],
    [1,1,1,1,0,0,0,0,0,0,0,0,0,0,0,0,0,0,1,0,0,0,0,0,0,0,0,1,1,1,1,1],
    [1,0,0,0,0,0,0,0,0,0,0,0,0,0,0,0,0,0,0,0,0,0,0,0,0,0,0,0,0,0,0,1],
    [1,0,0,0,0,0,1,0,0,0,0,0,0,0,0,1,0,0,0,0,0,0,0,0,0,0,0,0,0,0,0,1],
    [1,0,0,0,0,0,0,0,0,0,0,0,0,0,0,0,0,0,0,0,0,1,0,0,0,0,7,7,8,7,7,1],
    [1,0,0,1,0,0,0,0,0,0,0,0,0,0,0,0,0,0,0,0,0,0,0,0,0,0,7,0,0,0,7,1],
    [1,0,0,0,0,0,0,0,0,0,0,0,1,0,0,0,0,0,0,0,0,0,0,0,0,0,7,0,0,0,7,1],
    [1,0,0,0,0,0,0,0,0,0,0,0,0,0,0,0,0,0,0,0,0,0,0,0,0,0,7,0,0,0,7,1],
    [1,0,0,0,0,0,0,0,1,0,0,0,0,0,0,0,0,0,0,0,0,0,1,0,0,0,7,0,0,0,7,1],
    [1,0,0,0,0,0,0,0,0,0,0,0,0,0,0,0,0,0,0,0,0,0,0,0,0,0,7,0,9,0,7,1],
    [1,0,0,0,0,0,0,0,0,0,0,0,0,0,0,0,0,0,1,0,0,0,0,0,0,0,7,7,7,7,7,1],
    [1,1,0,0,0,0,0,0,0,0,1,0,0,0,0,0,0,0,0,0,0,0,0,0,0,0,0,0,0,0,0,1],
    [1,0,0,0,0,0,0,0,0,0,0,0,0,0,0,0,0,0,0,0,0,0,0,0,0,0,0,0,0,0,0,1],
    [1,0,0,0,0,0,0,0,0,0,0,0,0,0,0,0,0,0,0,0,0,0,0,0,0,0,0,0,0,0,0,1],
    [1,0,0,0,0,0,0,0,0,0,0,0,0,1,0,0,0,0,0,0,0,0,0,0,0,0,0,0,0,0,1,1],
    [1,1,1,1,1,1,1,1,1,1,1,1,1,1,1,1,1,1,1,1,1,1,1,1,1,1,1,1,1,1,1,1]
  ],
  "doors": [
    { "x": 28, "z": 20, "axis": "x", "type": "normal" }
  ],
  "entities": [
    { "type": "guard", "x": 5.5, "z": 28.5, "angle": 0, "patrol": true },
    { "type": "dog", "x": 10.5, "z": 26.5, "angle": 90, "patrol": true },
    { "type": "guard", "x": 3.5, "z": 22.5, "angle": 90, "patrol": false },
    { "type": "guard", "x": 14.5, "z": 20.5, "angle": 180, "patrol": true },
    { "type": "dog", "x": 8.5, "z": 15.5, "angle": 270, "patrol": true },
    { "type": "guard", "x": 20.5, "z": 18.5, "angle": 0, "patrol": false },
    { "type": "guard", "x": 25.5, "z": 15.5, "angle": 180, "patrol": true },
    { "type": "guard", "x": 12.5, "z": 8.5, "angle": 270, "patrol": false },
    { "type": "dog", "x": 18.5, "z": 5.5, "angle": 0, "patrol": true },
    { "type": "guard", "x": 28.5, "z": 22.5, "angle": 180, "patrol": false },
    { "type": "guard", "x": 6.5, "z": 4.5, "angle": 90, "patrol": true },
    { "type": "guard", "x": 22.5, "z": 10.5, "angle": 270, "patrol": false }
  ],
  "items": [
    { "type": "pistol_ammo", "x": 3.5, "z": 29.5 },
    { "type": "health_small", "x": 8.5, "z": 25.5 },
    { "type": "pistol_ammo", "x": 15.5, "z": 22.5 },
    { "type": "health_small", "x": 5.5, "z": 16.5 },
    { "type": "pistol_ammo", "x": 20.5, "z": 14.5 },
    { "type": "health_small", "x": 10.5, "z": 10.5 },
    { "type": "mp40", "x": 28.5, "z": 24.5 },
    { "type": "pistol_ammo", "x": 25.5, "z": 6.5 },
    { "type": "health_large", "x": 28.5, "z": 21.5 },
    { "type": "treasure_cross", "x": 2.5, "z": 14.5 },
    { "type": "pistol_ammo", "x": 16.5, "z": 9.5 }
  ],
  "secrets": [
    { "x": 12, "z": 12, "pushDir": "south" },
    { "x": 17, "z": 17, "pushDir": "east" }
  ],
  "secretItems": [
    { "type": "treasure_crown", "x": 2.5, "z": 13.5 },
    { "type": "health_large", "x": 3.5, "z": 13.5 },
    { "type": "treasure_chest", "x": 4.5, "z": 17.5 },
    { "type": "chaingun", "x": 3.5, "z": 17.5 }
  ],
  "exit": { "x": 28, "z": 25 },
  "par_time": 90,
  "music": "e5m1"
}