{
  "name": "Fettgesicht's Command Center",
  "episode": 6,
  "floor": 10,
  "width": 32,
  "height": 32,
  "wallHeight": 2.0,
  "isBossLevel": true,
  "bossType": "fettgesicht",
  "playerStart": { "x": 15, "z": 2, "angle": 0 },
  "walls": [
    [1,1,1,1,1,1,1,1,1,1,1,1,1,1,1,1,1,1,1,1,1,1,1,1,1,1,1,1,1,1,1,1],
    [1,1,1,1,1,1,1,1,1,1,1,1,1,7,7,7,7,7,1,1,1,1,1,1,1,1,1,1,1,1,1,1],
    [1,1,1,1,1,1,1,1,1,1,1,1,1,7,0,0,0,7,1,1,1,1,1,1,1,1,1,1,1,1,1,1],
    [1,1,1,1,1,1,1,1,1,1,1,1,1,7,0,0,0,7,1,1,1,1,1,1,1,1,1,1,1,1,1,1],
    [1,1,1,1,1,1,1,1,1,1,1,1,1,7,0,0,0,7,1,1,1,1,1,1,1,1,1,1,1,1,1,1],
    [1,1,1,1,1,1,1,1,1,1,1,1,1,7,0,0,0,7,1,1,1,1,1,1,1,1,1,1,1,1,1,1],
    [1,1,1,1,1,1,1,1,1,1,7,7,7,7,7,8,7,7,7,7,7,1,1,1,1,1,1,1,1,1,1,1],
    [1,1,1,1,1,1,1,1,1,1,7,0,0,0,0,0,0,0,0,0,7,1,1,1,1,1,1,1,1,1,1,1],
    [1,1,1,1,1,1,1,1,1,1,7,0,0,0,0,0,0,0,0,0,7,1,1,1,1,1,1,1,1,1,1,1],
    [1,1,1,1,1,1,1,1,1,1,7,0,0,0,0,0,0,0,0,0,7,1,1,1,1,1,1,1,1,1,1,1],
    [1,1,1,1,1,1,1,1,1,1,7,0,0,0,0,0,0,0,0,0,7,1,1,1,1,1,1,1,1,1,1,1],
    [1,1,1,1,7,7,7,7,7,7,7,7,7,7,7,8,7,7,7,7,7,7,7,7,7,7,7,1,1,1,1,1],
    [1,1,1,1,7,0,0,0,0,0,0,0,0,0,0,0,0,0,0,0,0,0,0,0,0,0,7,1,1,1,1,1],
    [1,1,1,1,7,0,0,0,0,0,0,0,0,0,0,0,0,0,0,0,0,0,0,0,0,0,7,1,1,1,1,1],
    [1,1,1,1,7,0,0,0,0,0,0,0,0,0,0,0,0,0,0,0,0,0,0,0,0,0,7,1,1,1,1,1],
    [1,1,1,1,7,0,0,0,0,7,0,0,0,0,0,0,0,0,0,0,0,7,0,0,0,0,7,1,1,1,1,1],
    [1,1,1,1,7,0,0,0,0,0,0,0,0,0,0,0,0,0,0,0,0,0,0,0,0,0,7,1,1,1,1,1],
    [1,1,1,1,7,0,0,0,0,0,0,0,0,0,0,0,0,0,0,0,0,0,0,0,0,0,7,1,1,1,1,1],
    [1,1,1,1,7,0,0,0,0,7,0,0,0,0,0,0,0,0,0,0,0,7,0,0,0,0,7,1,1,1,1,1],
    [1,1,1,1,7,0,0,0,0,0,0,0,0,0,0,0,0,0,0,0,0,0,0,0,0,0,7,1,1,1,1,1],
    [1,1,1,1,7,0,0,0,0,0,0,0,0,0,0,0,0,0,0,0,0,0,0,0,0,0,7,1,1,1,1,1],
    [1,1,1,1,7,0,0,0,0,7,0,0,0,0,0,0,0,0,0,0,0,7,0,0,0,0,7,1,1,1,1,1],
    [1,1,1,1,7,0,0,0,0,0,0,0,0,0,0,0,0,0,0,0,0,0,0,0,0,0,7,1,1,1,1,1],
    [1,1,1,1,7,0,0,0,0,0,0,0,0,0,0,0,0,0,0,0,0,0,0,0,0,0,7,1,1,1,1,1],
    [1,1,1,1,7,0,0,0,0,0,0,0,0,0,0,0,0,0,0,0,0,0,0,0,0,0,7,1,1,1,1,1],
    [1,1,1,1,7,7,7,7,7,7,7,7,7,7,7,9,7,7,7,7,7,7,7,7,7,7,7,1,1,1,1,1],
    [1,1,1,1,1,1,1,1,1,1,1,1,1,1,1,0,1,1,1,1,1,1,1,1,1,1,1,1,1,1,1,1],
    [1,1,1,1,1,1,1,1,1,1,1,1,1,1,1,1,1,1,1,1,1,1,1,1,1,1,1,1,1,1,1,1],
    [1,1,1,1,1,1,1,1,1,1,1,1,1,1,1,1,1,1,1,1,1,1,1,1,1,1,1,1,1,1,1,1],
    [1,1,1,1,1,1,1,1,1,1,1,1,1,1,1,1,1,1,1,1,1,1,1,1,1,1,1,1,1,1,1,1],
    [1,1,1,1,1,1,1,1,1,1,1,1,1,1,1,1,1,1,1,1,1,1,1,1,1,1,1,1,1,1,1,1],
    [1,1,1,1,1,1,1,1,1,1,1,1,1,1,1,1,1,1,1,1,1,1,1,1,1,1,1,1,1,1,1,1]
  ],
  "doors": [
    { "x": 15, "z": 6, "axis": "x", "type": "normal" },
    { "x": 15, "z": 11, "axis": "x", "type": "normal", "bossDoor": true }
  ],
  "entities": [],
  "items": [
    { "type": "health_large", "x": 11.5, "z": 7.5 },
    { "type": "health_large", "x": 19.5, "z": 7.5 },
    { "type": "health_large", "x": 15.5, "z": 7.5 },
    { "type": "health_large", "x": 11.5, "z": 9.5 },
    { "type": "health_large", "x": 19.5, "z": 9.5 },
    { "type": "pistol_ammo", "x": 12.5, "z": 8.5 },
    { "type": "pistol_ammo", "x": 18.5, "z": 8.5 },
    { "type": "pistol_ammo", "x": 15.5, "z": 8.5 },
    { "type": "pistol_ammo", "x": 13.5, "z": 9.5 },
    { "type": "pistol_ammo", "x": 17.5, "z": 9.5 },
    { "type": "pistol_ammo", "x": 15.5, "z": 10.5 },
    { "type": "health_small", "x": 14.5, "z": 7.5 },
    { "type": "health_small", "x": 16.5, "z": 7.5 },
    { "type": "chaingun", "x": 15.5, "z": 9.5 },
    { "type": "health_large", "x": 13.5, "z": 10.5 },
    { "type": "health_large", "x": 17.5, "z": 10.5 }
  ],
  "boss": {
    "type": "fettgesicht",
    "x": 15.5,
    "z": 21.5,
    "triggerZone": {
      "minX": 5,
      "maxX": 26,
      "minZ": 12,
      "maxZ": 25
    }
  },
  "secrets": [],
  "secretItems": [],
  "exit": { "x": 15, "z": 25 },
  "exitLocked": true,
  "par_time": 150,
  "music": "e6_boss"
}