{
  "name": "Der Übersoldat",
  "episode": 7,
  "floor": 10,
  "width": 32,
  "height": 32,
  "wallHeight": 2.0,
  "isBossLevel": true,
  "bossType": "ubersoldier",
  "playerStart": { "x": 15, "z": 2, "angle": 0 },
  "walls": [
    [1,1,1,1,1,1,1,1,1,1,1,1,1,1,1,1,1,1,1,1,1,1,1,1,1,1,1,1,1,1,1,1],
    [1,1,1,1,1,1,1,1,1,1,1,1,1,7,7,7,7,7,1,1,1,1,1,1,1,1,1,1,1,1,1,1],
    [1,1,1,1,1,1,1,1,1,1,1,1,1,7,0,0,0,7,1,1,1,1,1,1,1,1,1,1,1,1,1,1],
    [1,1,1,1,1,1,1,1,1,1,1,1,1,7,0,0,0,7,1,1,1,1,1,1,1,1,1,1,1,1,1,1],
    [1,1,1,1,1,1,1,1,1,1,1,1,1,7,0,0,0,7,1,1,1,1,1,1,1,1,1,1,1,1,1,1],
    [1,1,1,1,1,1,1,1,1,1,7,7,7,7,7,8,7,7,7,7,7,1,1,1,1,1,1,1,1,1,1,1],
    [1,1,1,1,1,1,1,1,1,1,7,0,0,0,0,0,0,0,0,0,7,1,1,1,1,1,1,1,1,1,1,1],
    [1,1,1,1,1,1,1,1,1,1,7,0,0,0,0,0,0,0,0,0,7,1,1,1,1,1,1,1,1,1,1,1],
    [1,1,1,1,1,1,1,1,1,1,7,0,0,0,0,0,0,0,0,0,7,1,1,1,1,1,1,1,1,1,1,1],
    [1,1,1,1,1,1,1,1,1,1,7,0,0,0,0,0,0,0,0,0,7,1,1,1,1,1,1,1,1,1,1,1],
    [1,1,1,7,7,7,7,7,7,7,7,7,7,7,7,8,7,7,7,7,7,7,7,7,7,7,7,7,7,1,1,1],
    [1,1,1,7,0,0,0,0,0,0,0,0,0,0,0,0,0,0,0,0,0,0,0,0,0,0,0,0,7,1,1,1],
    [1,1,1,7,0,0,0,0,0,0,0,0,0,0,0,0,0,0,0,0,0,0,0,0,0,0,0,0,7,1,1,1],
    [1,1,1,7,0,0,0,0,0,0,0,0,0,0,0,0,0,0,0,0,0,0,0,0,0,0,0,0,7,1,1,1],
    [1,1,1,7,0,0,0,0,7,0,0,0,0,0,0,0,0,0,0,0,0,0,0,7,0,0,0,0,7,1,1,1],
    [1,1,1,7,0,0,0,0,0,0,0,0,0,0,0,0,0,0,0,0,0,0,0,0,0,0,0,0,7,1,1,1],
    [1,1,1,7,0,0,0,0,0,0,0,0,0,0,0,0,0,0,0,0,0,0,0,0,0,0,0,0,7,1,1,1],
    [1,1,1,7,0,0,0,0,0,0,0,0,0,0,0,0,0,0,0,0,0,0,0,0,0,0,0,0,7,1,1,1],
    [1,1,1,7,0,0,0,0,7,0,0,0,0,0,0,0,0,0,0,0,0,0,0,7,0,0,0,0,7,1,1,1],
    [1,1,1,7,0,0,0,0,0,0,0,0,0,0,0,0,0,0,0,0,0,0,0,0,0,0,0,0,7,1,1,1],
    [1,1,1,7,0,0,0,0,0,0,0,0,0,0,0,0,0,0,0,0,0,0,0,0,0,0,0,0,7,1,1,1],
    [1,1,1,7,0,0,0,0,0,0,0,0,0,0,0,0,0,0,0,0,0,0,0,0,0,0,0,0,7,1,1,1],
    [1,1,1,7,0,0,0,0,7,0,0,0,0,0,0,0,0,0,0,0,0,0,0,7,0,0,0,0,7,1,1,1],
    [1,1,1,7,0,0,0,0,0,0,0,0,0,0,0,0,0,0,0,0,0,0,0,0,0,0,0,0,7,1,1,1],
    [1,1,1,7,0,0,0,0,0,0,0,0,0,0,0,0,0,0,0,0,0,0,0,0,0,0,0,0,7,1,1,1],
    [1,1,1,7,0,0,0,0,0,0,0,0,0,0,0,0,0,0,0,0,0,0,0,0,0,0,0,0,7,1,1,1],
    [1,1,1,7,7,7,7,7,7,7,7,7,7,7,7,9,7,7,7,7,7,7,7,7,7,7,7,7,7,1,1,1],
    [1,1,1,1,1,1,1,1,1,1,1,1,1,1,1,0,1,1,1,1,1,1,1,1,1,1,1,1,1,1,1,1],
    [1,1,1,1,1,1,1,1,1,1,1,1,1,1,1,1,1,1,1,1,1,1,1,1,1,1,1,1,1,1,1,1],
    [1,1,1,1,1,1,1,1,1,1,1,1,1,1,1,1,1,1,1,1,1,1,1,1,1,1,1,1,1,1,1,1],
    [1,1,1,1,1,1,1,1,1,1,1,1,1,1,1,1,1,1,1,1,1,1,1,1,1,1,1,1,1,1,1,1],
    [1,1,1,1,1,1,1,1,1,1,1,1,1,1,1,1,1,1,1,1,1,1,1,1,1,1,1,1,1,1,1,1]
  ],
  "doors": [
    { "x": 15, "z": 5, "axis": "x", "type": "normal" },
    { "x": 15, "z": 10, "axis": "x", "type": "normal", "bossDoor": true }
  ],
  "entities": [],
  "items": [
    { "type": "health_large", "x": 11.5, "z": 6.5 },
    { "type": "health_large", "x": 19.5, "z": 6.5 },
    { "type": "health_large", "x": 11.5, "z": 9.5 },
    { "type": "health_large", "x": 19.5, "z": 9.5 },
    { "type": "health_small", "x": 13.5, "z": 7.5 },
    { "type": "health_small", "x": 17.5, "z": 7.5 },
    { "type": "health_small", "x": 13.5, "z": 8.5 },
    { "type": "health_small", "x": 17.5, "z": 8.5 },
    { "type": "pistol_ammo", "x": 12.5, "z": 6.5 },
    { "type": "pistol_ammo", "x": 18.5, "z": 6.5 },
    { "type": "pistol_ammo", "x": 15.5, "z": 6.5 },
    { "type": "pistol_ammo", "x": 12.5, "z": 9.5 },
    { "type": "pistol_ammo", "x": 18.5, "z": 9.5 },
    { "type": "pistol_ammo", "x": 15.5, "z": 9.5 },
    { "type": "chaingun", "x": 15.5, "z": 7.5 },
    { "type": "mp40", "x": 15.5, "z": 8.5 }
  ],
  "boss": {
    "type": "ubersoldier",
    "x": 15.5,
    "z": 22.5,
    "triggerZone": {
      "minX": 4,
      "maxX": 28,
      "minZ": 11,
      "maxZ": 26
    }
  },
  "secrets": [],
  "secretItems": [],
  "exit": { "x": 15, "z": 26 },
  "exitLocked": true,
  "par_time": 180,
  "music": "e7_boss"
}